Pride and Prejudice - Jane Austen
Wuthering Heights - Emily Brontë
Sense and Sensibility - Jane Austen
Moby-Dick - Herman Melville
Great Expectations - Charles Dickens
To Kill a Mockingbird - Harper Lee
The Catcher in the Rye - J.D. Salinger
Dracula - Bram Stoker
Frankenstein - Mary Shelley
The Picture of Dorian Gray - Oscar Wilde
It Ends with Us - Colleen Hoover
It Starts with Us - Colleen Hoover
The Silent Patient - Alex Michaelides
Where the Crawdads Sing - Delia Owens
Eleanor Oliphant Is Completely Fine - Gail Honeyman
The Nightingale - Kristin Hannah
Educated - Tara Westover
The Goldfinch - Donna Tartt
Little Fires Everywhere - Celeste Ng
The Girl on the Train - Paula Hawkins
Big Little Lies - Liane Moriarty
Rebecca - Daphne du Maurier
The Hound of the Baskervilles - Arthur Conan Doyle
And Then There Were None - Agatha Christie
The Woman in White - Wilkie Collins
The Adventures of Sherlock Holmes - Arthur Conan Doyle
Gone Girl - Gillian Flynn
The Girl with the Dragon Tattoo - Stieg Larsson
Before I Go to Sleep - S.J. Watson
The Woman in the Window - A.J. Finn
The Girl Before - JP Delaney
1984 - George Orwell
Brave New World - Aldous Huxley
Dune - Frank Herbert
The Hobbit - J.R.R. Tolkien
Fahrenheit 451 - Ray Bradbury
The Hunger Games - Suzanne Collins
The Martian - Andy Weir
Ready Player One - Ernest Cline
The Name of the Wind - Patrick Rothfuss
Station Eleven - Emily St. John Mandel
Pride and Prejudice - Jane Austen
Jane Eyre - Charlotte Brontë
Sense and Sensibility - Jane Austen
Persuasion - Jane Austen
Emma - Jane Austen
The Rosie Project - Graeme Simsion
The Hating Game - Sally Thorne
Me Before You - Jojo Moyes
Red, White & Royal Blue - Casey McQuiston